+-------+                                                                                                                                                       
|.......|           +----------------------------+                                                                                                              
|.......#######     |............................|                                                                                                              
+---#---+     #######............................|                                      +---------------------------------------------+                         
    #               |............................|                                      |.............................................|                         
    #               |.......+--------+...........|              #####################   |.................................+-----------+                         
                    |.......|        |...........|              #               #       |.....+---------+.................|                                     
                    |.......|        |...........|         #########            ########|.....|         |.................|                                     
                    +--#----+        |...........|         #                            |.....|         |.................+-----------+                         
                       #             |...........+---------#-------+                    |.....+---------+.............................|                         
                    ####             |.............................|                    |.............................................|                         
                    #                |.............................|                    +----------------------#----------------------+                         
                    #                |.............................|                                           #                                                
                                     |.............................|                                           #                                                
                                     +----------#------------------+                                           #               ###########                      
                                                #                                                              #               #         #                      
                                                #    +-----------+                                             #               #    +----#---------------+      
     +---------------------------------+        #    |...........|                  +--------------------------#------+        #    |....................|      
     |.................................|        ######...........####################.................................|        ######....................|      
     |.................................|        #    |...........|                  |.................................|        #    |....................|      
     |......+---------------+..........|        #    |...........|                  |......+---------------+..........|        #    |....................|      
     |......|               |..........##########    +-----------+                  |......|               |..........##########    +--------------------+      
     |......|               |..........|                                            |......|               |..........|                                         
     |......|               |..........|                    #########################......+---------------+..........|                                         
     |......|               |..........######################                       |.................................|                                         
     +------+               +----------+               #                            +---------------------------------+                                         
                                                       #                                          #                                                             
                                                +------#------+                                   #                                                             
                                                |.............|                                   #     +----------+                                            
                                                |.............|##########################################..........|                                            
                                                |.............|                                         |..........|                                            
                                                +-------------+                                         |..........|                                            
                                                                                                        +----------+                                             